22222222222222222
25555555555555552
25000033333000052
25055555555555052
25055522222555052
25055555555555052
25555333333355552
25555355555355552
25555355555355552
25555355555355552
25555333333355552
25055555555555052
25055522222555052
25055555555555052
25000033333000052
25555555555555552
22222222222222222